der Apfel - elma - apple
die Banane - muz - banana
der Birne - armut - pear
der Käse - peynir - cheese
der Joghurt - yoğurt - yogurt
das Brot - ekmek - bread
der Schinken - jambon - ham
der Fisch - balık - fish
das Fleisch - et - meat
der Reis - pirinç - rice
die Kartoffel - patates - potato
der Salat - salata - salad
die Tomate - domates - tomato
der Kaffee - kahve - coffee
der Tee - çay - tea
der Saft - meyve suyu - juice
der Wein - şarap - wine
das Bier - bira - beer
der Zucker - şeker - sugar
das Salz - tuz - salt
die Butter - tereyağı - butter
das Öl - yağ - oil
der Kuchen - kek - cake
der Keks - kek - cookie
der Schokolade - çikolata - chocolate
der Eis - buz - ice cream
der Pudding - puding - pudding
der Honig - bal - honey
der Senf - hardal - mustard
die Mayonnaise - mayonez - mayonnaise
der Ketchup - ketçap - ketchup
der Senf - hardal - mustard
die Soße - sos - sauce
das Dressing - sos - dressing
der Pfeffer - biber - pepper
die Gewürze - baharat - spices
der Knoblauch - sarımsak - garlic
der Ingwer - zencefil - ginger
der Dill - dereotu - dill
die Petersilie - maydanoz - parsley