wahrnehmen - fark etmek - to perceive
verwalten - yönetmek - to manage
verursachen - neden olmak - to cause
verdienen - hak etmek - to deserve
schätzen - değer vermek - to value
intervenieren - müdahale etmek - to intervene
gestalten - biçimlendirmek - to shape
fordern - talep etmek - to demand
erwarten - beklemek - to expect
der Mörder - katil - murderer
der Pfad - yol - path
der Reichtum - zenginlik - wealth
der Ruhm - şöhret - fame
der Mangel - eksik - deficiency
der Himmel - gökyüzü - sky
der Grund - sebep - reason
das Gedächtnis - hafıza - memory
der Ersatz - yedek - replacement
die Beziehung - ilişki - relationship
der Verrat - ihanet - betrayal
schmerzhaft - acı - painful
ruhmreich - şöhretli - renowned
wünschenswert - arzu edilir - desirable
der Anspruch - talep - claim
die Gerechtigkeit - adalet - justice
das Gewissen - vicdan - conscience
abgeschieden - terkedilmiş - abandoned
hasserfüllt - nefret dolu - hatred-filled
der Selbstmord - intihar - suicide
das Selbstbewusstsein - kendine güven - self-confidence
der Missbrauch - istismar - abuse
die Nachhaltigkeit - sürdürülebilirlik - sustainability
das Vorurteil - önyargı - prejudice
die Ermutigung - cesaretlendirme - encouragement
einflussreich - etkili - influential
auswegslos - çıkış yolu olmayan - hopeless
einwandfrei - itirazsız - flawless
der Aufstieg - yükseliş - rise
verfolgen - takip etmek - track, follow
das Ereignis, -se - olay, etkinlik - event