begeisteren - heyecanlandırmak - to excite
ausatmen - nefes vermek - to exhale
als erstes - ilk olarak - firstly
die Auszeit - ara verme - break
der Wecker - alarm - alarm clock
schließlich - sonuçta - finally
springen - atlamak - to jump
steigen - çıkmak - to climb
bauen - inşa etmek - to build
hüpfen - zıplamak - to hop
hupen - korna çalmak - to honk
auf und ab - yukarı aşağı - up and down
nicken - başını sallamak - to nod
pflücken - toplamak - to pick
das Feld - tarlalar - field
die Frucht - meyve - fruit
herrlich - harika - splendid
besitzen - sahip olmak - to possess
besaß - sahip olmuş - possessed
wohl - iyi - well
bewusst - bilinçli - conscious
der Schritt - adım - step
befreien - özgürlük vermek - to free
gründlich - kapsamlı - thorough
erkunden - keşfetmek - to explore
gerade - düz - straight
entlang - boyunca - along
aufgehen - açılmak - to open
einstieg - giriş - entry
losfahren - yola çıkmak - to start
ablegen - bırakmak - to leave
abnehmen - çıkarmak - to remove
aushalten - dayanmak - to endure
sondern - ayrıca - moreover
der Ausblick - manzara - view
ehemalig - eski - former
Der Begriff - tanım - term
achten - dikkat etmek - to pay attention
sparsam - tasarruflu - thrifty
aufmerksam - dikkatli - attentive
selten - seyrek - rare
berichten - rapor etmek - to report
mutig - cesur - brave
treu - sadık - loyal
klug - zeki - wise